NO     ./textures/1 .png    .png
WE	./textures/4.png
EA	./textures/3.png
SO	./textures/2.png

F 255   ,255,255
C 154,214,11






1111111111111111111111111111111111
10101011001100000100000000000111
1111111110110000100000001010111
10010000011100010000W01000100101
111100000000000000000001011111
111111111011000001110001001001
100000000011000001110111111111
111101111111110111000001010001
111101111111110111010101010001
110000001101010111000001010001
100000000000000011000001010001
100010000000000011010101010001
110000011101010111110111110011
111W11111110101110111110100001
111111111111111111111111111111
