111111111111111111111111111111
1w1010110110000010000000000011
111111111011000010000000010101
1001000001110001000w0010001001
111100100000000000000000101111
111110111011000001110001001001
100000000011000001110111111111
111101111111110111000001010001
111101111111110111010101010001
110000001101010111000001010001
100000000000000011000001010001
100010000000000011010101010001
110000011101010111110111100011
11101111111010111011111010w001
111111111111111111111111111111 