111111111111111111111111111111
1111w1100110000010000000000011
111111110110000100000000101011
100100000111000100000010001001
111100100000000000000000101111
111110111011000001110001001001
100000000011000001110111111111
111101111111111111000001010001
111101111111110111010101010001
110000001101000111000001010001
100000000000000011000001010001
100010000000000000000101010001
110000011101010111110000000011
1101111111101001101111101000w1
111111111111111111111111111111