111111111111111111111111111111
100000000011000000000001111111
111000000011000000000001111111
1W1100000111000000000001011111
111100000000000000000001011111
111111111011000001110001001001
100000000011000001110111111111
111101111111110111000001010001
111101111111110111010101010001
110000001101010111000001010001
100000000000000011000001010001
1000N0000000000011010101010001
110000011101010111110111110011
1111N1111111010111011111010001
111111111111111111111111111111