111111111111111111111111111111
10101011011000001000000000001
111111111011000010000000010101
10010000011100010000W010001001
11110-1000000000000000001011111
111111111011000001110001001001
100000000011000001110111111111
111101111111110111000001010001
111101111111110111010101010001
110000001101010111000001010001
100000000000000011000001010001
100010000000000011010101010001
110000011101010111110111110011
111W11111110101110111110100001
111111111111111111111111111111 