111111111111111111111111111111
101010110110000010000000000011
111111111011000010000000010101
10010000011100010000W010001001
111100100000000000000000101111
111110111w11000001110001001001
100000000011000001110111111111
111101111111110111000001010001
111101111111110111010101010001
110000001101010111000001010001
100000000000000011000001010001
100010000000000011010101010001
110000011101010111110111110011
111011111110101110111110100001
111111111111111111111111111111 