111111111111111111111111111111
111101100110000010000000000011
11111111011000010000000010101
100100000111000100000010001001
111100100000000000000000101111
111110111011000001110001001001
10000000001100w001110111111111
111101111111110111000001010001
111101111111110111010101010001
110000001101000111000001010001
100000000000000011000001010001
100010000000000000000101010001
110000011101010111110000000011
110111111110101110111110100001
111111111111111111111111111111