11111111111111111111111111111
10000000001100000000000110011
10110000011100000000000010011
10010000000000000000000011111
11111111101100000111000001001
10000000001100000111011111111
11110111111111011100000010001
11110111111111011101010010101
11000000110101011100000010101
10000000000000001100000010101
1000N000000W00001101010010101
11000001110101011111011110011
11110111111101011101111010001
11111111111111111111111111111