NO ./textures/n.png
SO ./textures/s.png
WE ./textures/w.png
EA ./textures/e.png

F     255, 255, 024
C     200, 00, 200

111111111111111111111111111111111111111111111111111111111111111111111111111111      
1110101100110000010000000000000000000000111
11000001000000000000100000000011100000000111
100000001010000000S0000000100011000000111
10000000000000101000001000D001100000011 
1111111110110000010100010010000000011111
10000000001100000111011111100011100000001
11110111111111011100000101000000000000001
11110111111111011101D10101000000000000001
11000000110101011100000101000010000000001
1000000000000000110000010100000D000010001        11
10001000000000001101010101000000100D00001       1001
11000001110101011111011111000000001000011        11
11111111111010111011111010000000000000001
11111111111111111111111111111111111111111111111111111111111111111111111111111
