NO ./textures/north_2.png
SO ./textures/so2.png
WE ./textures/west_2.png
EA ./textures/east_2.png

F     0, 0, 0
C     41, 0, 61

1111111111111111111111111111111111111111111 
1110101100110000010000000000000000000000111
11000001000000000000001000000000000000111
1000000010101000000000000000000000000111
100000000000N000111000100000000000000111
1111111110110000000000010010000000011111
10000000001100000111011111100010100000001
11110111111111011100000101000000000000001
11110111111111011101010101000000000000001
11000000110101011100000100000000000000001
10000000000000001100000001000000000000001        11
10001000000000001101010101000000000000001       1001
11000001110101011111011111000000000000011        11
11100000000000000000000000000000000000001
11111111111111111111111111111111111111111