NO  ./textures/1 .png    .xpm
WE	./textures/4.png
EA	./textures/3.png
SO	./textures/2.png

F 255,255,255
C 15,154 ,45

111111111111111111111111111111111111111111
1110101100110000010000000000000000000000111
1100000000000000000000000000011111000000111
100000000000000000000000000001   100000011
100000000000001D10000000000001   100000011 
111111111011000001110001001001   10000001
100000000011000W0111011111100011100000001
11110111111111011100000101000000001000001
1111011111111101110101010100000000D000001
11000000110101011100000101000000001000001
10000000000000001100000101000000000000001        11
100010000000000011010101010000000000000D1       1001
11000001110101011111011111000000000000011        11
11111111111010111011111010000000000000001
1111111 11111111111111111111111111111111111
 
11111
11111