NO  ./textures/1 .png    .xpm
WE	./textures/4.png
EA	./textures/3.png
SO	./textures/2.png
NO  ./sources/textures/3.png
WE	./sources/textures/2.png
EA	./sources/textures/dead.png
SO	./sources/textures/3.png

F 255,255,255
C 154,214,11

111111111111111111111111111111111111111111111111111111111111111111111111111111      
1110101100110000010000000000000000000000000000000000000000000000000000000000111
11000001000000000000000000000011111000000000000000000000000000000000000000000111
1000000010100000000000000000001100000000000000000000000000000000000000000011
100000000000001010000000000001100000000000000000000000000000000000000000011 
11111111101100000111000100100100000000000000000000000000000000000000000011111
100000000011000W0111011111100011100000000000000000000000000000000000000000001
11110111111111011100000101000000001000000000000000000000000000000000000000001
11110111111111011101010101000000000000000000000000000000000000000000000000001
11000000110101011100000101000000001000000000000000000000000000000000000000001
10000000000000001100000101000000000000000000000000000000000000000000000000001        11
10001000000000001101010101000000000000000000000000000000000000000000000000001       1001
11000001110101011111011111000000000000000000000000000000000000000000000000011        11
11111111111010111011111010000000000000000000000000000000000000000000000000001
11111111111111111111111111110000011111111111111111111111111111111111111111111
                111111111100000000011111
                         111100111100111
                            11011111111
                            110111
                            1101
                            1101
                        111110001111
                        100000000001
                        100000000001
                        111111111111
