NO ./textures/1.png
SO ./textures/2.png
WE ./textures/3.png
EA ./textures/4.png

F     72, 50, 72
C     41, 0, 61

111111111111111111111111111111111111111111111111111111111111111111111111111111      
1110101100110000010000000000000000000000111
11000001000000000000000000000011100000000111
100000001010000000S0000000000011000000111
100000000000001010000000000001100000011 
111111111011000001D100010010000000011111
10000000001100000111011111100011100000001
11110111111111011100000101000000000000001
11110111111111011101010101000000000000001
11000000110101011100000101000000000000001
10000000000000001100000101000000000000001        11
10001000000000001101010101000000000000001       1001
11000001110101011111011111000000000000011        11
11111111111010111011111010000000000000001
11111111111111111111111111111111111111111111111111111111111111111111111111111
