NO ./sources/textures/1.png
SO ./sources/textures/2.png
WE ./sources/textures/3.png
EA ./sources/textures/4.png

F     72, 50, 72
C     41, 0, 61


111111111111111111111111111111111111111111111111111111111111111111111111111111      
1110101100110000010000000000000000000000000000000000000000000000000000000000111
11000001000000000000000000000011111000000000000000000000000000000000000000000111
10000000101000000000000000000011000000000000000000000000000000000000000000111
100000000000001010000000000001100000000000000000000000000000000000000000011 
11111111101100000111000100100100000000000000000000000000000000000000000011111
10000000001100000111011111100011100000000000000000000000000000000000000000001
11110111111111011100000101000000001000000000000000000000000000000000000000001
11110111111111011101010101000000000000000000000000000000000000000000000000001
11000000110101011100000101000000001000000000000000000000000000000000000000001
100000000000000011000W0101000000000000000000000000000000000000000000000000001        11
10001000000000001101010101000000000000000000000000000000000000000000000000001       1001
11000001110101011111011111000000000000000000000000000000000000000000000000011        11
11111111111010111011111010000000000000000000000000000000000000000000000000001
11111111111111111111111111111111111111111111111111111111111111111111111111111
