NO  ./textures/1 .png    .xpm
WE	./textures/4.png
EA	./textures/3.png
SO	./textures/2.png

F 255,255,255
C 154,214,11






11111111111111111111111111111111111111111111111111111111111
101010110011000001000000000000000000000000000000000000000111
110000000000000000000000000000000000000000000000000000000111
1W000000000000000000000000000000000000000000000000000000011
10000000000000000000000000000000000000000000000000000000011 
1111111110110000011100010010000000000000000000000000000001
1000000000110000011101111110000000000000000000000000000001
1111011111111101110000010100000000000000000000000000000001
1111011111111101110101010100000000000000000000000000000001
1100000011010101110000010100000000000000000000000000000001
1000000000000000110000010100000000000000000000000000000001
1000100000000000110101010100000000000000000000000000000001
1100000111010101111101111100000000000000000000000000000011
1111111111101011101111101000000000000000000000000000000001
11111111111111111111111111111111111111111111111111111111111